----------X----------------------------------------o----?----------------------o----------X---M----------------------------------X-----X---M----o------o----Xo---o--------M--M-oo---------X---X-------X-
---X--------------------------------------------------------------------------o-----M-B--MX---------------------------------M----o-M----o----B--B---------M-X--------B--------M--------o----------------
----M-----BB-------M-----------------??------------Mo------M-----o--------------------B--oB---M---------?-----XoM--B----M--------B----M---------B----B----o-??-----?-o?-------M--BX----?----------B-----
--X?-M----------BB?----M---------------?-----------?--------------X--X-B----------------B-M---M-----?---XM-B-?B--?----------B--B-B-?--?---------X--?-----M--??M??--------X-M-XXMM-?-M--M--M--------B?-X-
---------------?----B---XX--B-B?--X----M-----B---B--B---M--BB----M-------X------------X--?----X--?------M--X--?X?-?Mo--------B---B-B-M-B---?---M----?----X-M?-X-MMB--M-XX----?--BB-X--MB--o-B--MX-?B--X-
-M-X---BX-BB------X?---X---X----------------X-X----M----M--------------------XB----B?-M---M--M?---------X--X-X----MMB--?-?----X----X---X------M-?-X--?-?M-X--?-------XX---XM?--?M----B-M-X?--------X-MB-
---X------?B--B-B-BX-?-B-----B--?--B-XM-B---M--------X--X--B-----B------------?--M--?----B?B-?B---------B---BXMMXB-?B-------X------B--M----B---M--?----BBBXM??M---X---X-----X-XB-M--------?-?MX-M--B--?-
---B--?---?-------?B-X------M?MM?BM??X--X-B-B-----BX--?----B--------M--B-----?X--X----------------------?B-MB-B-o---X--------B---X??---B--?M?----?--BX-?-??--?--?XBM--M?--M-BXXBXBM-X---M-?---MX--?B--?v
-M-?-?M-M-M--M??-B-BBBB?-??-?X-MX-?-B-B--XB------BMo-oXMM-X--B---MM--B-MXX?--B--X--B-?BX-?BMB-BXX-M-BX?---?-Xo-BXX?MB-oM-?--?X-?X??M?-?X-MXB-BX?-X?BBX-?XB?M-?BXoXMM-?--o?B??M-o-XXM??-----?BX--?---BX?f
---B------M------?-M------BXM--------B--?X--X------?----M----?-----?---oM-----------M----B---??--------BX?-M--?X--?XM----B-XX-BM-M-o---B---M-------?-M--XX-??BB---X--B-B?MM-M??-MBB-?-XBM---------X-X-Bf
---B------?B-X--?-BX-------------------------------BBM--XM-------X---M-?----------X-?----MBX-------M-----B?X---M---B--------------XX-?--B-B--M-XX----B-B--M-??------------??-BX-M-?----X--M------?-M--?f
----?-----------?-??B---M---B------?--MM----B---X---M---M------?-M---M-X----?----?--MXB--BX--BM------M--MX-BM--o-?-XB-------------?-B---?--X----B-BXMM-BM?--BBM-M-B?-BB-XB?---BBB-M---oB-------?M--?---f
-BX-MB---?Xo--XX?-B--MM?M-X-X-BXX--BMX-X?M------B-BX?--M---?-XMB-B-B-M-??X-MB?X---BMX---M?-BB--?-XBX-M?-B--B?BBBB-?--MB----?MBM-MX-X--M-BBB--MXB-X-oM-XMXo?BX-XM---B-X?-BM-X?-B-M?--XX?BXM?-BXMM--?-MM?f
--XB----?-X-----BXBB-----------------B?------?------M?--?------X-X---B-B------?-----X-X--X-B--MB--M?----MX----MBM-MB?M-XB-B-----?-MXX-XX-------XM?----M-BXX-?-X--B?--MM--?X-BX?B-?X---BB----?--BBBMX---f
m--XX----BB?XX--XXXX--X--X-B---X------X--M----X----MM------XB----?----XB-M--X-X----MM-X-X---X??-B---X-M-?XXMX-?-?X--X--X---X?----MXBX--BXX-M-X--?--XX--XXM?--X--XXB-?-BoX-?o--oo-XBB?X--X-B-X?-----XX?XX
XXX-XXoXXX-XX-XXXXX-XX-XXXXXXXXXXXXXXX-XXXXXo-XXXXX-BXXXXXXXXXXXXXXX?XX?XXXX?XXXXXXXXXMX--oXXMXXXXXXXXXX?BoXXXMX?XBX-XX-XXX-BXXXX-XXXXXB-BMX-XXo-X?XMXX--??XXXXXXM-XXXBB-?-XXBXBBoXMX-X-XXoXX-?XXXX-XX-X
