---------------X---M-B----------------------------------X---o-------------------------M-----M---?-------------B-B--------------?-------------?---------M-----------------------------BX---------o-------
------X?-----XM------M-------?-------X----o--------B----?----?----------------M-----M---oo-----?-?------------------?-------X--X-----M-------X---------B-------------o------o-------------------------X-
-------XB------MM----?-----M-----------------------o-M--M--------X----------B---o--------X------------B---------MX--------B---------------M---X--------?----------BX---------M------M----------B---X----
------X?--M---X-X---?X-----XM-----B--XB--M?XX------Bo---?--B-B--XX-M-----------M--?-B----B-M?-XM?X-X----X---X---?|-B------B----X---?-X----B------BM----M--------B----?---B---B------o-X--?BB-----?-B?---
-------MB-X----XM--B?XBB--BB-?M?----XM----M---B-----?B--o----?---X------------M-?---X---M-?---?-------M---?-X--o---XXB---------MBX--------M-XBB------B------------X--X-X-B--X----M---XMBX-?B-----?-XM---
--B----?M-?X-------B?X-M-BM?---------M--------------MX--X----M---M-?-----X--M-------M---X--X?-?--B----X---------?X---M-X----MB----M-XB---?--X---?-o---BM--X?------X--M---XM--?------?---?-B----?-?-BX---
------M-BB---B-----M--?M-?-X------M--BB----------M-XM---XX--oM--B----XX--------MM---?-----------------X-M---M---?B-XX?----M----M--M-------B-MB-X--B----?-MX----X--X--M---?M-MB------BX-B-B----M----BB---
-------XB------M--?BXX---M??-M--M--M-M---X-M----M--B---------?----BB-------M?-M-XB-------MMB-BXB-?----------M--M----------?----------X--------B---X|--??--MM----XBBX---B-B---B----X-?X----B------?-X---v
----------B--------?B?-M-?---M----??--o--M-----------M----M--M---?B------X------?M-------?-M--B----?--X-?---M--XBX-B?----BX-X-XXB----B----?--B-----|-M-M--------X--M-----?-----M--M--B--X-o------X-B---f
------B---M-----B---M?-----M-M-B----B-X---------M------------BMXB--------MX---------X?--------?-XM------?---?----?-BM?B---X----------B--M--X------X---XX---------BX----?-----?-----------BB------?-B?-Xf
--------o-----??-EM?BM-----?-------M-BB-------------MM--X-----------X-B-M-----B-X--MM----X-B-M---MMM-BM-----M---?M-XX-----M----M-----M----M---?---B|---XX--------X?--X--MB-BBB------M?-X-M-----B-M--B-Xf
-------o--o-B------??X-?X--M-XM-M----MM-----X--------B--M--------------B---M----M---M---M?----X--B---M---B-XX---?B-B-X---BX??-?--------------M-?--|---M--?--------X--MB------B?----M?-----?--------?B--f
----X---X-----BB---?M-??---X-?-X-X--M------B----X-M-BBB------?-----X-----X--?M--B----?--?----M?-??----B--BM-?---MX-?---X-------B----BX-------X-----X-MBBM------------?----------------?--B--?--X---B-B-f
-------MX-----X----B-MMX-----B---o-??-B------?---B--MX-------B-M---------B--------BBB----X--X-X--X----M-?-X?----M?-?-B---------?---M-M------------M?--X??--------MXM-B--M?M-MB--M---XMXM-X?--------?M--f
m--X--XXM-?----M---XM--------?----M--X---XX---------M---B----X---B----X------X--M---XM--oX-XX-B-X-X--XX---X-XX---X-XBX----X--Bo---MB-B----M--X--M-B---X?---------BB--?---X--?X-B-X--XXX-??B----X-?-X?--X
XX-XXXXX-oXXXXXXXXXB?XXXXXXXXXXXXXXXXX?XXXXXXXXXXXXXX-XXB-XXX-XXXXXXXBXXXX-XXXXXXXXXXXXX-X---XXXX-XX-X--X?XX-XXX-XX?XBMXXX-X-XXXXXXXX-XXXXBXXBXX-XXX-o--XXXoXX?XXXXXXXXXXXXXXXXXX-XXXXXXXooXXXBX-XXX?-XX
