--------------------------------------------------------------------------------------------------------------------------------------------------------------------------------------------------------
--------------------------------------------------------------------------------------------------------------------------------------------------------------------------------------------------------
--------------------------------------------------------------------------------------------------------------------------------------------------------------------------------------------------------
--------------------------------------------------------------------------------------------------------------------------------------------------------------------------------------------------------
---------------------------------------------------------------------------------------o----------------------------------------------------------------------------------------------------------------
-------------------------------------------------------------------------------------o-o--------------------------------------------oo------------------------------------------------------------------
--------------------------------------------------------------------------------------------------------------------------------------------------------------------------------------------------------
-------------------------------------------------------------------------------------------------------------------------------------------------------------------------------------------------------v
-------------------------------------------------------------T-----------------------------------------------------------------------------------------------------------------------------------------f
---------B---------------------------------------------------|---------------------------------------------------------------------------------X-------------------------------------------------------f
-------------------------------------------------------------|---------------------------------------------------------------------------------XX------------------------------------------------------f
----??????--------------------------T---------T-------T------|---------T--------------------------------------------------------------------XXXXXXXX---------------------------------------?-----------f
------------------------------------|---------|-------|------|---------|-----------------------------------------------------------------------XXXX----------------------------------------------X-----f
------------------------------------|---------|-------|------|---------|-----------------------------------------------------------------------XXXXX--------------------------------------------XX-----f
mE----------------------------------|---------|-------|------|---------|--------------------------------------------------------------------XXXXXXXXX----------------X-------------------------XXX-----X
XXXXXXXXXXXXXXXXXXXXXXXXXXXXXXXXXXXX|XXXXXXXXX|XXXXXXX|XXXXXX|XXXXXXXXX|XXXXXXXXXXXXXXXXXXXXXXXXXXXXXXXXXXXX-XXX--X-X-----XXX-XXXXXXXXXXXXXXXXXXXXXXXXXXXXXXXXXXXXXXXXXXXXXXXXXXXXXXXXXXXXXXXXXXXXXXXXXX
