--------------------------------------------------------------------------------------------------------------------------------------------------------------------------------------------------------
-------------------------------------------------------------------------------------------------------------------------------------E------------------------------------------------------------------
--------------------------------------------------------------------------------------------------------------------------------------------------------------------------------------------------------
------X--------------------B-------------------------------B----X---?o--------B---------------------------------------------o--X--?BM--------?---------M-----------?----B?------------------------------
--------------?----o-------?---------------------o------------------B----------------------B-----------------------E-------X---M--?----------?-----?-------------?--------------------------M-----------
------?-------B------------B-----M----------?------?------------------------M--B-----------?--B--------------------------?-------------------?-----X--------B---B--X----------B-------------------------
------X--------------------------?----------B----------------------------------M-BE-----EX??--------------------BXBBB-------X----------------------?-?-------------X----------M-------------M-----M-----
-----------------------o---?-----------------------------------?---------------M-B---------------------------------X--------M---M-----?--------------B-o----X----M-M--?-------M----------------o--M----v
--------------M------------------------------------M------------M---B---------?X-?M---XB---M--X---o----------------------------X?-?---M------------B?---------------------------------------------?----f
------B--------------------M-----X------BM---------------------X------------------------------?-----------------------------X--BX-----X------?------B-------?---M--B-----B------------------M----------f
------?--------------o-----------------------------M-X-----B---------X-o------B--M------------?--------------------X-----------X-------------------MM--B----B-----------------M-------------X----------f
------------------o--------B------------------------------------------------B-XX--------------------------------------------B--BX------------X-------X----------?--B----?-------------------M----------f
--------------?------------?------------?----------------------------X------X--M-----------?-E-E------B------------------?--B----------------------XX--?----M----X----X-M-----?-------------------?----f
------B-----E-----------X-BM----E?-----XM------------------X----M----?---------------------------------------------?----X-------------------X--E-----M----------MM-------X-------o--E------------------f
m--------------------------------------X?X---------X------------?-M-?--------o---------------XX-----M--------------B-----M-?----XXM---XX----XX-------B-----------X-X-----B----------------------o-MX---X
XXXXXXXXXXXXXXXXXXXXXXXXXXXXXXXXXXXXXXXXXXX-M-XXXXXXXXXXXXXXXXXXXXXXMXXXXXXXXXXXXXXX-X---XXBXXXXXXXXXXXXXXXXXXXXXXXXXXXXXXX-XXXXXXXXXXXXXXXXXXXXXXXXXXXXXXXXXXXX-XXXXXXXXXXXXX?XXXXXXXXXXXXXXXXXXX-XXXXX
