--------------------------------------------------------------------------------------------------------------------------------------------------------------------------------------------------------
--------------------------------------------------------------------------------------------------------------------------------------------------------------------------------------------------------
--------------------------------------------------------------------------------------------------------------------------------------------------------------------------------------------------------
-X-B-----B---------------------B-----------B-----------------M------M-----------------------M------?---------------B-?--------------BX---B---X-----------------------------------X------------------M---
--XM--MM--?X-?-----?---------M--M--M--?-M-------BM-?---?----B--?------X---B------?-?-----B------?-------B-X-----?--------XB?--M-----------------B?------B?M---X--B-B------X-?-----MM--MX---B-------MXX--
------B--------?------------B--?----------X-------B-----------------?M-----------------------------M-------o----------X--M------------------------------------MX---M----------?--------------------M----
--B-------------------------XX---------------X-----B-------------B?B---------------------------------------------M----------X-----MX---M-------------X----------B------M---B---------?-------?------M---
--------------?-?--X-----?----------------------MB----------------------MB-------X-------------?--M-----M---------X-------X--B-----------M-------------------?-B-?---------------M----------M---MMB---Bv
-X-MB--??--M--M?---X--M---M--X-MXX---M?-M--?B--MMB----MX-MBB---BM---X-B--M--?---??---M-XBB----?------X-M---X--M-M-----XM--M----?--?----------?--M----B-B----M-MM----BXX-------X---M-MX-?MB-----??X---M-f
------------X-B-------M----X---X---M-------------------------?-M-------------------X---B?--M------M-----M-B-----------------------------------------?-B---B--M----------X-----?-------B----B--MX-------f
--XM-------?----B---M-----------------?-X?---?-------------?-----------?------------M----------------------------------------------B---X-------------X-------------------?----------BB-B----------M----f
---------------X------------------------------------?-BX------BB-------------MX-B----?--------B-B-----B----B--------------------?--------X-?-------------------------X-------------------M----?-------?f
---??-------MX---------B---M--------------------X------?----?-------------B----------------------M-----------------------M---B-----M-?----?----------B-----------M-------------------------X----?-?----f
-M------------X-------X----X---------------?-------------M-X--------------M--------BX--------X------------------X----X------M-?---------------------------------?----X------B-B---------------------?--f
m--M--------B-------X--------X----------B-X----?---------B-X-XX------X---X----XX---------X-----B----------XX----------?--------?------?X-BX-----X?--------X-----------------M-X---------X---XX----X-X--X
XXXXXXXXXXX?XX-XXXX-XXXXXXXXXX-XXXXXXXXXXXXXXXXXXXXXXXXXXMXXXXXXXXXXX-XXXXXXX-XXXXXXXXXX-XXXBXXXXXXXXX?XXXXXXX-XXXXXX-XXoXXXXXBXXXXXXXX---XXXXXX?XXXXXBXXXX-XXXXXXXXXXXXXXXXXXXXXXXXXXXXX-X-X-XXXXXM--XX
