-------------------------------------------------------------------------------B----------------------------------------------X-------------------------------------------------------------------------
--------------------------------------------o--------------------------------------------------------------------------------XXXXX----------------------------------------------------------------------
-------------------------------------------------------------o------------------------------------------------------------------------------------------------------------------------------------------
----------------------------------------------------------B-----------------------------------------o------------?------------------------------------------------------------M-------------------------
----------------------------------------------------------------------------------------------------------T----------------------------------o----------------------------------------------------------
------------------------------------------XXXXXXXXBB------------------------------------------------o-----|---------------------------------------------------------------------------------------------
----------------------------------------Bo-----------B----------------------------------X-----------------|---------------------------------------------------------------------------------------------
-----------------------------------B----------------------------------------------o-----------------B-----|--------------------------?-----------------------------------------------------------------v
----------------------------------------------------------------------------------------------------------|---------B-----------------------------------------------------------------------?----------f
------------------------------------------------------------------------------?---------------X-----------|------------------------------BBBBBBBB------------------------------------------------------f
-----------------?-----------------------?----------------------------------------------------XX----------|---------B-----X--------------X-------------------X----------M-----------------X------------f
-------------------------------------------------?--------------------------------------------XXX---------|---------------------------X---------------------XX-----------------------------------------f
-----------------------------------------------------------------------------------T----------XXXX--------|----------------------------------?-------------XXX----------------------T------------------f
-----------------------------------------------------------------------------------|-----T----XXXXX-------|-------------------------------------------X---XXXX----------------------|------------------f
m-------------------------------------E--------------------------------------------|-----|----XXXXXX------|--E----------------------E-----------------XX-XXXXX----------------------|------------------X
XXXXXXXXXXXXXXXXXXXXXXXXXXXXXXXX-XXXXXXXXXXXXXXXXXXXXXXXXXXXXXXXXX--------XXXXXXXXX|XXXX-|---XXXXXXXXXXXXX|X--XXXXXXXXXXXXXXXXXXXXXXXXXXXXXXXX-------XXXXXXXXXXXXXXXXXXXXXXXXXXXXXX-|----XXXXXXXXXXXXXXX
